WE ./texture/siryakari-furnace2.png
SO ./texture/siryakari-furnace1.png
EA ./texture/siryakari-furnace2.png
NO ./texture/siryakari-furnace.png

F 255,229,204
C 204,255,255

                      1
        1111111111111101111111111
        1000000000000000000000001
        1000000000000100000010001
        10000N0000000000000000001
111111111011000001110000100000001
100000000011000001110000000111111
11110111111111011100000010001
11110111111111011101010010001
11000000110101011100000000001
10000000000000000000000010001
100000000000000000000000000001
110000011101010111110000001001
11110111 1110101 101111010001
11111111 1111111 111111111111
