WE ./texture/andesite_doubleslab.png
SO ./texture/stone_brick_doubleslab_top.png
EA ./texture/stone_brick_doubleslab.png
NO ./texture/stone_doubleslab.png

F 255,229,204
C 204,255,255

                      1
        1111111111111101111111111
        1000000000110000000000001
        101100000111000000000001
        10010N000000000000000001
111111111011000001110000000000001
100000000011000001110111111111111
11110111111111011100000010001
11110111111111011101010010001
11000000110101011100000000001
10000000000000001100000010001
10000000000000001101000000001
110000011101010111110000001001
11110111 1110101 101111010001
11111111 1111111 111111111111
