WE ./texture/west.png
SO ./texture/south.png
EA ./texture/east.png
NO ./texture/north.png

F 220, 100,0
C 225,30,0



11111111111111111111111111111
10000000001100000111011111111
11110111111111011100000010001
11110111111111011101010010001
11000000110101011100000000001
100000000000000011000N0010001
10000000000000001101000000001
11000001110101011111000000101
11110111111101011101111010001
11111111111111111111111111111