WE ./texture/siryakari-furnace2.png    	    	   		
SO ./texture/siryakari-furnace.png
EA ./texture/siryakari-furnace2.png
NO ./texture/siryakari-furnace1.png
F 255,229,204
C 204,255,255


111111111111111111
111111111111111111
111111111N11111111
111111111111111111